111111111111111111111111111
110000000000000C00000C00001
101001010010000010100100001
101011001010101000100100001
1P0010110C00C00000000E000C1
1P0010110C00C00000000E000C1
1P0010110C00C00000000E000C1
111111111111111111111111111

